         . .   .  .              .   .       ..                                      .           .     .               .         .          
   .                        .  .          . .                 .     .           .  .   ..                  .     .             .      .     
            .      .       .     . .                         .             . .      .      ..      .                                        
.         .                        .   .    .            . .                             .   .       . .                     .  .  .  .     
                        .                                                                                            ..         .      .    
        .       .                .                                  .       .    .    .         .                    .   . .                
                       . .              .          .    . ... .                  .        ******   .                       .                
                      .        .        .           .     . .        . .           .      ******           .. .       .             .       
     .            ..                            .         . .     .                .      *******  . **   .    .  .                 .  .  . 
       .       .           . .        ..    . .      .**   .  .     .      .           ..********  ***** ***           ..   .  .    .       
 .        .  .     .       .         **     .. .   *******                           **  ********  *********         .**     ..             
         .              .    . .   *****.   . .  **********   **      .   ***     .  ** *********   ********  **.   ****         ..  .      
       . .            ..     **  . *****     ******** *****  ***   . .    *****  .  *************** **********************                  
   .       . .. .   . **     **. ******** ** ********** ** ***** .   *** ******   . *********************** **************** .            . 
       .       .     .**     **  ************************* **.*** ** ***********. ** *************************************** .         .    
    .                 ** **  ********* *****************************************.************************ ******************                
     .          ..    ********************************************************** *********** *************** ** ******** ***  **     .      
            .  .    *********************************************************************** **********.********************* ***            
    .   .   .       ****.*************************** *********** *** ************************************ **********************            
.                 ************************************** **************************  *********************************** ****** . .         
.. .              ***************************** *************************** ***************** ****** *************** ************.          
.                 ******** ************************************ ***************************************************************** .    .    
                  ************ ****************************************************** *****************************************             
         .     .  **************************************************** *********************************************** ********* .          
         ..        **.********************************** ***********************************************************************       ..   
         . .      ***************** ************************** ********************** *****************************************  .          
 .   . .  .     . ************************************************************************************************ ************            .
        .    **  ************* ******************* ******************** *******************************************************             
           ************************ ********** ****************************** *****************************************************   ..    
           ************************************************************************************************************************         
          *************************************************** ***********************************************************************   .   
      . *************************************************************************************************** ********* ***************  .    
  .    .****************************************************************************.**************************** ******************  . .   
      .********************** ********************************* ******************************************************************     .    
       ******************************************************************************************** *****************************.   .      
.  ..  ********** ************************************************************************************************** **********       .   . 
       ***** ************** ******** *********************** **.********************************** ** ** **********************             
   .     **  ************************************************************************************************************* ****             
         ** ******************************* **** *********************** ************ **** *************************************         .  
         *********************************************** ***************************************************** *****************    .       
         ********************************************************************** ************************************ ************  . . .  . 
      .   ************************** **** ****** ********** ***************************************************** ***************** .       
 .        **************************** ** ******************************************************* ****************************** **     .   
    .     ******************************************************************* *****************************************************         
     .   *********************** *************************************************** ***** *************** **************************       
        .************* *************************** ***************************************************************** ************* **       
          ******** ********************* ************************************.*******************************.*********** ** ********       
 .        ************************************************************************************************** ** *********************       
   .   **   ******************************* ** ******************************* ************************************************ ****        
      *** ******** *********************** ******* *******************.*************** ********* *********************************          
      *************************************************************************** ***************** ********* **** ***************          
       *************************** ************ ***********************.****************************************************** *****        
  .   *** ******** ************************************************* *********************** ********* *********************** *****   . .  
   .  *** ******************************************************************  ***************** ******** ****************** ******          
  .   ****************** *********.************************************************ ********************************** **********  .        
      ********** ****************************************** *********************************************************************           
      *************************************************** ********* ***  ********* ******************************** ***********      .   .  
        *********************************** *********** ***********      ************.******************************** ******** **        ..
    .   ************* *************************.*********** ********   .  ** ******************************* **********************  .      
        *************************************************** **********    ** ***     **********************************************         
      .. ** ************************************ ********** **********.   **  **    **********************************************       .  
  .  ..  .  **************.*******************************************          .   **********************.** ******************            
     .     ******************************************* ***************  .            **** ************************************              
 .     ..********** ************************** ******************.****         .     *******************************************            
        ******************** ********** *********************.********       .         *************************** ****************         
        ************************** ********************* ************                    ********** **** *************** **********         
        **** ****** *************************************************      .   .    .   *******************************************         
    .  . **************************************.**************** **    .         .      *********************************************    .  
         *********************************************** *********.     .  .         ** ******************** **.********** ************   . 
   . .     *******************************************************                  .*********************** ******* ****************** .  .
         ************ **** ****************** **************** ****               .  **************************************************     
.    .   ***********************************************.**********          ..      .************ *********************************      . 
         *********** *********************************** **********             .  .    ****************************** *********** **      .
       .   ************ ************************************** **    .          .       ********* ************************************      
        . ***** ***********************************************        .        .    .. ********** ********* *************************      
          ************************** **** *********************       .            **.************************************************      
     .  .  ******************************* *** *********** ***   .  ..         **************** ********************.*******************    
           ****************** ******************************** **    **        *********************************** *********************    
  ..     ************************************ *******************    ***     *********************************************************** .  
 .       ************* *********** **** *************************** ****.    ********S********************** ************* *************.   
  .     .******************** ***************************************** .  ************************************* ****** **********        . 
         ** *** ****************************************************** **********************************************************           
   .       ************************** ****************************************************** ************************************* ..       
           **************** **************** ** *********.**  .*******************************************************************          
.  ..       ***********************************************     *** ** ****** ** *******************************************.** ** .        
      . **  ** ************************* ** ******************************************** ****************** ********** **.** **     .   .   
        ******.****************.************************************************************************** ********************             
        **************************** *************.**** ************************************************************************            
     .    ************************ ************************************************************************** ********************    .     
       *************************** ****************************************************** ****************************************         .
 ********************** ************ ***** ******************************************************* ************************************     
 **************** ***************************** *************************************************************** ******** ***************    
  .************** .***************************************** ************************ ****** *** **** ************************* **** ***    
 .  .**********************************************************************************************************************************     
   .******************************************************************************************* ********** ** ******** ****************..   
   ************ ******** *************** ************* ***** *********************************** **************************** *******      .
  .************* ************************************** ************************************* *************************************         
 . .****************************************************************** ****************************** ******.** *******************      .  
  ** ************************************************************* *************************** *************************************   .    
  *************************************************************************************** ************************** ***************    .   
  **************************** ********************************************************************** ******** **********************       
.   **.*******************************************************************************************************************************      
        *********************************.******** ******* ************.****** ********** *********************** ********************  .   
   ..    ******************** ** ******************************************************************************* ***********************   .
         ******************************* ***********************************************************************************************    
      .   ** ********************************************************************************************************************** ****.   
             ************************************* **************************** ** ********* ************************************  ***    . 
             *********** ****************************** ***** ****.**************************************************************  *** .    
             *************** ****************** *** ******************* **** ************** ********************************** **     .     
       .     ***************************.************************************** *********************************************  ***          
    .      ************************************************** ****** **************** ***************************************  ***          
          ************* *********************** ********** ********************* ********************************************  **         . 
 .   .    ******** ************************************************************************************************************ .           
           .****  ** ****************************************** ********************* *****************************************             
     . .. *****.************************* ******* *************************************************************************** .   .         
        ******  ********* *********************** **** ************************.******************************* ******************     .    
        ****    ************* ******.********************** ** ***************************************** ********** ****** *******      .   
        **       .************************************************************** *********** *****************************  **.**  . .  .   
      .       .  ************************************* *******************************************************************    .             
            .... ************* ***********************************************************************************   ****       ..          
            .   .*************************************************************** **********************************.     .       .       . .
             .  *********************** ******** *** *********************** ***************************************   .   .                
.               ************* **************************************************************************************.  .                    
  .   ..         . ** ************************* **************** ******** *************.*************************  .   .                    
 . .. . .       . ..********** ***** ****************************************************.******************* ***        . .         .   .  
     .   .   ..     **** ******************************** ***************************************************.** .  .    . .       .       .
.    .    ..     .  ** *********************************************************************************** **..       .              . .    
         .             *************** ***************************************** ****** ******************   .        .        .            
 ..       .     . .     **   ****** *************** *********** **************** *** .********** *****.*****  ..   .                        
  . .       . .    .  . **    ****  ***********    .** **************  ***** *** ***  ********** *****.*****                 .  .           
 .      . .               .   ****    . *** ****       ****  ***..**   ***** **         ******** ** **  **   .                              
 .                       .           . **** ****        ***  *******   . **  ***    . . ******             .   .       .  .        .        
          .       . . .  .     .       ***   ***.  .  .      *****           ***.       . ****   .        .      . .               .   ..   
      .       .  ..               ...   **.  ***    ... .                 .     .        .  **     .    .                                   
              .   . .            .              .    .          .        ..                                .                       . .     .
   .   .   .                           ..        .              .  .  .    .          .       .           .   .  .                          
     .        .   .    . .     .    .                ...   .                       .                                          ..            
              .     .            .                 .                            .       ..   .      ...      .       ..  .                . 
        .  .                    .   .                       .                            .   .    .              .       ..                 
          .                                                ..          .  ...            . .                 .      .    .  .   .        .  
